武内P		
赤羽根P		
真耶子		
ミンゴス		
ヘレン		
繪里子		
玲音		
Machico		
ケイト		
ナターリア		
双海亜美／真美		
双海亜美・真美		
春香		
千早		
雪歩		
やよい		
律子		
あずさ		
伊織		
真		
亜美／真美		
亜美・真美		
亜美		
真美		
高木社長		
愛美		
ロコ		
ジュリア		
エミリー		
ルゥ・ティン		
小鳥		
ぴよぴよ		
たかにゃ		
ちびき		
あふぅ		
こまみ		
こあみ		
まこちー		
いお		
みうらさん		
ちっちゃん		
やよ		
ゆきぽ		
ちひゃー		
はるかさん		
美希		
M・A・O		
トレーナー		
ベテラントレーナー		
貴音		
響		
黒井社長		
マスタートレーナー		
夢子		
ライラ		
アナスタシア		
クラリス		
ルーキートレーナー		
イヴ・サンタクロース		
愛		
絵理		
涼		
石川社長		
メアリー・コクラン		
サイネリア		
キャシー・グラハム		
エミリー・スチュアート		
相川千夏	あいかわ ちなつ	相川 千夏
愛野渚	あいの なぎさ	愛野 渚
藍原ことみ	あいはら ことみ	藍原 ことみ
相原雪乃	あいはら ゆきの	相原 雪乃
相葉夕美	あいば ゆみ	相葉 夕美
青木瑠璃子	あおき るりこ	青木 瑠璃子
赤城みりあ	あかぎ みりあ	赤城 みりあ
赤﨑千夏	あかさき ちなつ	赤﨑 千夏
赤西瑛梨華	あかにし えりか	赤西 瑛梨華
赤羽根健治	あかばね けんじ	赤羽根 健治
秋月律子	あきづき りつこ	秋月 律子
秋月涼	あきづき りょう	秋月 涼
浅倉杏美	あさくら あずみ	浅倉 杏美
麻倉もも	あさくら もも	麻倉 もも
浅野風香	あさの ふうか	浅野 風香
浅利七海	あさり ななみ	浅利 七海
安部菜々	あべ なな	安部 菜々
阿部里果	あべ りか	阿部 里果
天ヶ瀬冬馬	あまがせ とうま	天ヶ瀬 冬馬
天海春香	あまみ はるか	天海 春香
雨宮天	あまみや そら	雨宮 天
綾瀬穂乃香	あやせ ほのか	綾瀬 穂乃香
荒木比奈	あらき ひな	荒木 比奈
有浦柑奈	ありうら かんな	有浦 柑奈
安斎都	あんざい みやこ	安斎 都
飯田友子	いいだ ゆうこ	飯田 友子
五十嵐響子	いがらし きょうこ	五十嵐 響子
五十嵐裕美	いがらし ひろみ	五十嵐 裕美
池袋晶葉	いけぶくろ あきは	池袋 晶葉
伊集院北斗	いじゅういん ほくと	伊集院 北斗
伊集院惠	いじゅういん めぐみ	伊集院 惠
一ノ瀬志希	いちのせ しき	一ノ瀬 志希
市原仁奈	いちはら にな	市原 仁奈
市道真央	いちみち まお	市道 真央
伊藤美来	いとう みく	伊藤 美来
稲川英里	いながわ えり	稲川 英里
伊吹翼	いぶき つばさ	伊吹 翼
今井麻夏	いまい あさか	今井 麻夏
今井麻美	いまい あさみ	今井 麻美
今井加奈	いまい かな	今井 加奈
井村雪菜	いむら せつな	井村 雪菜
上坂すみれ	うえさか すみれ	上坂 すみれ
上田鈴帆	うえだ すずほ	上田 鈴帆
上田麗奈	うえだ れいな	上田 麗奈
氏家むつみ	うじいえ むつみ	氏家 むつみ
歌田音	うただ おと	歌田 音
内田真礼	うちだ まあや	内田 真礼
内田雄馬	うちだ ゆうま	内田 雄馬
梅木音葉	うめき おとは	梅木 音葉
梅原裕一郎	うめはら ゆういちろう	梅原 裕一郎
江上椿	えがみ つばき	江上 椿
衛藤美紗希	えとう みさき	衛藤 美紗希
海老原菜帆	えびはら なほ	海老原 菜帆
及川雫	おいかわ しずく	及川 雫
桜咲千依	おうさき ちよ	桜咲 千依
大石泉	おおいし いずみ	大石 泉
大川透	おおかわ とおる	大川 透
大神環	おおがみ たまき	大神 環
大関英里	おおぜき えり	大関 英里
大空直美	おおぞら なおみ	大空 直美
太田優	おおた ゆう	太田 優
大塚芳忠	おおつか ほうちゅう	大塚 芳忠
大槻唯	おおつき ゆい	大槻 唯
大坪由佳	おおつぼ ゆか	大坪 由佳
大西由里子	おおにし ゆりこ	大西 由里子
大沼くるみ	おおぬま くるみ	大沼 くるみ
大橋彩香	おおはし あやか	大橋 彩香
大原みちる	おおはら みちる	大原 みちる
岡崎泰葉	おかざき やすは	岡崎 泰葉
岡本まなみ	おかもと まなみ	岡本 まなみ
小笠原早紀	おがさわら さき	小笠原 早紀
緒方智絵里	おがた ちえり	緒方 智絵里
奥山沙織	おくやま さおり	奥山 沙織
尾崎玲子	おざき れいこ	尾崎 玲子
落合祐里香	おちあい ゆりか	落合 祐里香
乙倉悠貴	おとくら ゆうき	乙倉 悠貴
音無小鳥	おとなし ことり	音無 小鳥
角元明日香	かくもと あすか	角元 明日香
春日未来	かすが みらい	春日 未来
片桐早苗	かたぎり さなえ	片桐 早苗
金子真由美	かねこ まゆみ	金子 真由美
金子有希	かねこ ゆうき	金子 有希
郁原ゆう	かはら ゆう	郁原 ゆう
上条春菜	かみじょう はるな	上条 春菜
神谷奈緒	かみや なお	神谷 奈緒
嘉山未紗	かやま みさ	嘉山 未紗
軽口哲也	かるくち てつや	軽口 哲也
川島瑞樹	かわしま みずき	川島 瑞樹
神崎蘭子	かんざき らんこ	神崎 蘭子
神原大地	かんばら だいち	神原 大地
我那覇響	がなは ひびき	我那覇 響
菊地真	きくち まこと	菊地 真
如月千早	きさらぎ ちはや	如月 千早
岸部彩華	きしべ あやか	岸部 彩華
喜多日菜子	きた ひなこ	喜多 日菜子
北上麗花	きたかみ れいか	北上 麗花
北川真尋	きたがわ まひろ	北川 真尋
北沢志保	きたざわ しほ	北沢 志保
喜多見柚	きたみ ゆず	喜多見 柚
木戸衣吹	きど いぶき	木戸 衣吹
木下ひなた	きのした ひなた	木下 ひなた
木場真奈美	きば まなみ	木場 真奈美
木村珠莉	きむら じゅり	木村 珠莉
木村夏樹	きむら なつき	木村 夏樹
桐谷蝶々	きりたに ちょうちょ	桐谷 蝶々
桐野アヤ	きりの あや	桐野 アヤ
桐生つかさ	きりゅう つかさ	桐生 つかさ
釘宮理恵	くぎみや りえ	釘宮 理恵
日下部若葉	くさかべ わかば	日下部 若葉
工藤忍	くどう しのぶ	工藤 忍
久野美咲	くの みさき	久野 美咲
栗原ネネ	くりはら ねね	栗原 ネネ
黒井崇男	くろい たかお	黒井 崇男
黒川千秋	くろかわ ちあき	黒川 千秋
黒沢ともよ	くろさわ ともよ	黒沢 ともよ
小岩井ことり	こいわい ことり	小岩井 ことり
高坂海美	こうさか うみ	高坂 海美
古賀小春	こが こはる	古賀 小春
輿水幸子	こしみず さちこ	輿水 幸子
小関麗奈	こせき れいな	小関 麗奈
小早川紗枝	こばやかわ さえ	小早川 紗枝
小日向美穂	こひなた みほ	小日向 美穂
駒形友梨	こまがた ゆり	駒形 友梨
小松伊吹	こまつ いぶき	小松 伊吹
小室千奈美	こむろ ちなみ	小室 千奈美
子安武人	こやす たけひと	子安 武人
近藤唯	こんどう ゆい	近藤 唯
西園寺琴歌	さいおんじ ことか	西園寺 琴歌
斉藤佑圭	さいとう ゆか	斉藤 佑圭
斉藤洋子	さいとう ようこ	斉藤 洋子
冴島清美	さえじま きよみ	冴島 清美
榊原里美	さかきばら さとみ	榊原 里美
鷺沢文香	さぎさわ ふみか	鷺沢 文香
佐久間まゆ	さくま まゆ	佐久間 まゆ
櫻井桃華	さくらい ももか	櫻井 桃華
桜井夢子	さくらい ゆめこ	桜井 夢子
佐々木千枝	ささき ちえ	佐々木 千枝
佐城雪美	さじょう ゆきみ	佐城 雪美
佐竹美奈子	さたけ みなこ	佐竹 美奈子
佐藤亜美菜	さとう あみな	佐藤 亜美菜
佐藤心	さとう しん	佐藤 心
佐藤利奈	さとう りな	佐藤 利奈
沢田麻理菜	さわだ まりな	沢田 麻理菜
三瓶由布子	さんぺい ゆうこ	三瓶 由布子
財前時子	ざいぜん ときこ	財前 時子
椎名法子	しいな のりこ	椎名 法子
塩見周子	しおみ しゅうこ	塩見 周子
四条貴音	しじょう たかね	四条 貴音
篠原礼	しのはら れい	篠原 礼
篠宮可憐	しのみや かれん	篠宮 可憐
渋谷凛	しぶや りん	渋谷 凛
島原エレナ	しまばら えれな	島原 エレナ
島村卯月	しまむら うづき	島村 卯月
下地紫野	しもじ しの	下地 紫野
下田麻美	しもだ あさみ	下田 麻美
首藤葵	しゅとう あおい	首藤 葵
白井悠介	しらい ゆうすけ	白井 悠介
白菊ほたる	しらぎく ほたる	白菊 ほたる
白坂小梅	しらさか こうめ	白坂 小梅
城ヶ崎美嘉	じょうがさき みか	城ヶ崎 美嘉
城ヶ崎莉嘉	じょうがさき りか	城ヶ崎 莉嘉
末柄里恵	すえがら りえ	末柄 里恵
周防桃子	すおう ももこ	周防 桃子
杉坂海	すぎさか うみ	杉坂 海
洲崎綾	すざき あや	洲崎 綾
鈴木彩音	すずき あやね	鈴木 彩音
鈴木絵理	すずき えり	鈴木 絵理
涼宮星花	すずみや せいか	涼宮 星花
諏訪彩花	すわ あやか	諏訪 彩花
関裕美	せき ひろみ	関 裕美
瀬名詩織	せな しおり	瀬名 詩織
千川ちひろ	せんかわ ちひろ	千川 ちひろ
仙崎恵磨	せんざき えま	仙崎 恵磨
相馬夏美	そうま なつみ	相馬 夏美
高垣楓	たかがき かえで	高垣 楓
高木順一朗	たかぎ じゅんいちろう	高木 順一朗
高木順二朗	たかぎ じゅんじろう	高木 順二朗
高塚智人	たかつか ともひと	高塚 智人
高槻やよい	たかつき やよい	高槻 やよい
髙野麻美	たかの あさみ	髙野 麻美
たかはし智秋	たかはし ちあき	たかはし 智秋
高橋未奈美	たかはし みなみ	高橋 未奈美
高橋礼子	たかはし れいこ	高橋 礼子
鷹富士茄子	たかふじ かこ	鷹富士 茄子
高峯のあ	たかみね のあ	高峯 のあ
高森藍子	たかもり あいこ	高森 藍子
高森奈津美	たかもり なつみ	高森 奈津美
高山紗代子	たかやま さよこ	高山 紗代子
滝田樹里	たきた じゅり	滝田 樹里
武内駿輔	たけうち しゅんすけ	武内 駿輔
竹達彩奈	たけたつ あやな	竹達 彩奈
武田蒼一	たけだ そういち	武田 蒼一
田澤茉純	たざわ ますみ	田澤 茉純
多田李衣菜	ただ りいな	多田 李衣菜
橘ありす	たちばな ありす	橘 ありす
立花理香	たちばな りか	立花 理香
田所あずさ	たどころ あずさ	田所 あずさ
田中琴葉	たなか ことは	田中 琴葉
種田梨沙	たねだ りさ	種田 梨沙
田村奈央	たむら なお	田村 奈央
伊達朱里紗	だて ありさ	伊達 朱里紗
茅原実里	ちはら みのり	茅原 実里
千葉翔也	ちば しょうや	千葉 翔也
月宮雅	つきみや みやび	月宮 雅
津田美波	つだ みなみ	津田 美波
土屋亜子	つちや あこ	土屋 亜子
寺川愛美	てらかわ あいみ	寺川 愛美
寺島拓篤	てらしま たくま	寺島 拓篤
天空橋朋花	てんくうばし ともか	天空橋 朋花
東郷あい	とうごう あい	東郷 あい
東山奈央	とうやま なお	東山 奈央
徳川まつり	とくがわ まつり	徳川 まつり
徳丸完	とくまる かん	徳丸 完
所恵美	ところ めぐみ	所 恵美
戸田めぐみ	とだ めぐみ	戸田 めぐみ
十時愛梨	ととき あいり	十時 愛梨
戸松遥	とまつ はるか	戸松 遥
都丸ちよ	とまる ちよ	都丸 ちよ
豊川風花	とよかわ ふうか	豊川 風花
道明寺歌鈴	どうみょうじ かりん	道明寺 歌鈴
中谷育	なかたに いく	中谷 育
中野有香	なかの ゆか	中野 有香
中村温姫	なかむら あつき	中村 温姫
中村繪里子	なかむら えりこ	中村 繪里子
仲村宗悟	なかむら しゅうご	仲村 宗悟
長島光那	ながしま みな	長島 光那
永塚拓馬	ながつか たくま	永塚 拓馬
長富蓮実	ながとみ はすみ	長富 蓮実
永吉昴	ながよし すばる	永吉 昴
夏川椎菜	なつかわ しいな	夏川 椎菜
七尾百合子	ななお ゆりこ	七尾 百合子
並木芽衣子	なみき めいこ	並木 芽衣子
成宮由愛	なるみや ゆめ	成宮 由愛
南条光	なんじょう ひかる	南条 光
難波笑美	なんば えみ	難波 笑美
二階堂千鶴	にかいどう ちづる	二階堂 千鶴
仁後真耶子	にご まやこ	仁後 真耶子
西川保奈美	にしかわ ほなみ	西川 保奈美
西島櫂	にしじま かい	西島 櫂
新田ひより	にった ひより	新田 ひより
新田美波	にった みなみ	新田 美波
二宮飛鳥	にのみや あすか	二宮 飛鳥
丹羽仁美	にわ ひとみ	丹羽 仁美
沼倉愛美	ぬまくら まなみ	沼倉 愛美
野上翔	のがみ しょう	野上 翔
野々原茜	ののはら あかね	野々原 茜
野々村そら	ののむら そら	野々村 そら
野村香菜子	のむら かなこ	野村 香菜子
萩原雪歩	はぎわら ゆきほ	萩原 雪歩
箱崎星梨花	はこざき せりか	箱崎 星梨花
長谷優里奈	はせ ゆりな	長谷 優里奈
長谷川明子	はせがわ あきこ	長谷川 明子
服部瞳子	はっとり とうこ	服部 瞳子
花澤香菜	はなざわ かな	花澤 香菜
浜川愛結奈	はまかわ あゆな	浜川 愛結奈
浜口あやめ	はまぐち あやめ	浜口 あやめ
浜崎奈々	はまさき なな	浜崎 奈々
早坂美玲	はやさか みれい	早坂 美玲
速水奏	はやみ かなで	速水 奏
早見沙織	はやみ さおり	早見 沙織
原紗友里	はら さゆり	原 紗友里
原優子	はら ゆうこ	原 優子
原由実	はら ゆみ	原 由実
原嶋あかり	はらしま あかり	原嶋 あかり
原田ひとみ	はらだ ひとみ	原田 ひとみ
原田美世	はらだ みよ	原田 美世
春野ななみ	はるの ななみ	春野 ななみ
伴田路子	はんだ ろこ	伴田 路子
馬場このみ	ばば このみ	馬場 このみ
柊志乃	ひいらぎ しの	柊 志乃
日高愛	ひだか あい	日高 愛
日野茜	ひの あかね	日野 茜
姫川友紀	ひめかわ ゆき	姫川 友紀
兵藤レナ	ひょうどう れな	兵藤 レナ
平田宏美	ひらた ひろみ	平田 宏美
平山笑美	ひらやま えみ	平山 笑美
福田のり子	ふくだ のりこ	福田 のり子
福原綾香	ふくはら あやか	福原 綾香
福山舞	ふくやま まい	福山 舞
藤居朋	ふじい とも	藤居 朋
藤井ゆきよ	ふじい ゆきよ	藤井 ゆきよ
藤田茜	ふじた あかね	藤田 茜
藤村歩	ふじむら あゆみ	藤村 歩
藤本里奈	ふじもと りな	藤本 里奈
藤原肇	ふじわら はじめ	藤原 肇
双葉杏	ふたば あんず	双葉 杏
双海亜美	ふたみ あみ	双海 亜美
双海真美	ふたみ まみ	双海 真美
渕上舞	ふちがみ まい	渕上 舞
古澤頼子	ふるさわ よりこ	古澤 頼子
北条加蓮	ほうじょう かれん	北条 加蓮
星輝子	ほし しょうこ	星 輝子
星井美希	ほしい みき	星井 美希
細井治	ほそい おさむ	細井 治
堀裕子	ほり ゆうこ	堀 裕子
堀江瞬	ほりえ しゅん	堀江 瞬
本田未央	ほんだ みお	本田 未央
舞浜歩	まいはま あゆむ	舞浜 歩
前川みく	まえかわ みく	前川 みく
真壁瑞希	まかべ みずき	真壁 瑞希
牧野由依	まきの ゆい	牧野 由依
槙原志保	まきはら しほ	槙原 志保
間島淳司	まじま じゅんじ	間島 淳司
松井恵理子	まつい えりこ	松井 恵理子
松尾千鶴	まつお ちづる	松尾 千鶴
松岡禎丞	まつおか よしつぐ	松岡 禎丞
松嵜麗	まつざき れい	松嵜 麗
松田亜利沙	まつだ ありさ	松田 亜利沙
松田颯水	まつだ さつみ	松田 颯水
松永涼	まつなが りょう	松永 涼
松原早耶	まつばら さや	松原 早耶
松本沙理奈	まつもと さりな	松本 沙理奈
松山久美子	まつやま くみこ	松山 久美子
的場梨沙	まとば りさ	的場 梨沙
間中美里	まなか みさと	間中 美里
真鍋いつき	まなべ いつき	真鍋 いつき
三浦あずさ	みうら あずさ	三浦 あずさ
水木聖來	みずき せいら	水木 聖來
水谷絵理	みずたに えり	水谷 絵理
水野翠	みずの みどり	水野 翠
水本ゆかり	みずもと ゆかり	水本 ゆかり
御手洗翔太	みたらい しょうた	御手洗 翔太
水瀬伊織	みなせ いおり	水瀬 伊織
三船美優	みふね みゆ	三船 美優
三村かな子	みむら かなこ	三村 かな子
宮尾美也	みやお みや	宮尾 美也
三宅麻理恵	みやけ まりえ	三宅 麻理恵
宮本フレデリカ	みやもと ふれでりか	宮本 フレデリカ
三好紗南	みよし さな	三好 紗南
向井拓海	むかい たくみ	向井 拓海
棟方愛海	むなかた あつみ	棟方 愛海
村上巴	むらかみ ともえ	村上 巴
村川梨衣	むらかわ りえ	村川 梨衣
村中知	むらなか とも	村中 知
村松さくら	むらまつ さくら	村松 さくら
最上静香	もがみ しずか	最上 静香
持田亜里沙	もちだ ありさ	持田 亜里沙
望月杏奈	もちづき あんな	望月 杏奈
望月聖	もちづき ひじり	望月 聖
桃井あずき	ももい あずき	桃井 あずき
百瀬莉緒	ももせ りお	百瀬 莉緒
森久保乃々	もりくぼ のの	森久保 乃々
杜野まこ	もりの まこ	杜野 まこ
諸星きらり	もろぼし きらり	諸星 きらり
楊菲菲	やお ふぇいふぇい	楊 菲菲
八神マキノ	やがみ まきの	八神 マキノ
矢口美羽	やぐち みう	矢口 美羽
八代拓	やしろ たく	八代 拓
安野希世乃	やすの きよの	安野 希世乃
柳清良	やなぎ きよら	柳 清良
柳瀬美由紀	やなせ みゆき	柳瀬 美由紀
矢吹可奈	やぶき かな	矢吹 可奈
山口立花子	やまぐち りかこ	山口 立花子
山崎すぎお	やまさき すぎお	山崎 すぎお
山崎はるか	やまざき はるか	山崎 はるか
山下七海	やました ななみ	山下 七海
大和亜季	やまと あき	大和 亜季
山本希望	やまもと のぞみ	山本 希望
結城晴	ゆうき はる	結城 晴
遊佐こずえ	ゆさ こずえ	遊佐 こずえ
横山千佳	よこやま ちか	横山 千佳
横山奈緒	よこやま なお	横山 奈緒
吉岡沙紀	よしおか さき	吉岡 沙紀
佳村はるか	よしむら はるか	佳村 はるか
依田芳乃	よりた よしの	依田 芳乃
龍崎薫	りゅうざき かおる	龍崎 薫
若林智香	わかばやし ともか	若林 智香
若林直美	わかばやし なおみ	若林 直美
和氣あず未	わき あずみ	和氣 あず未
脇山珠美	わきやま たまみ	脇 山珠美
和久井留美	わくい るみ	和久井 留美
渡部恵子	わたなべ けいこ	渡部 恵子
渡辺紘	わたなべ ひろし	渡辺 紘
渡部優衣	わたなべ ゆい	渡部 優衣のぐちゆり